103 103 102 102 102 102 102 102 102 102 102 102 102 102 102 102 102 102 102 102 102 102 102 102 102 102 102 102 102 102 102 102 102 102 102 102 102 102 103 103 103 103 103 103 103 103 103 103 103 103 
103 102 102 102 102 64 67 68 67 68 67 68 69 102 102 102 102 102 102 102 102 102 102 102 102 102 102 102 102 102 102 102 102 102 102 102 102 102 102 102 102 103 103 103 103 103 103 103 103 103 
102 102 102 102 64 66 37 129 37 127 37 37 65 67 68 67 67 68 67 69 102 102 64 68 67 68 67 67 69 102 102 102 102 102 64 69 102 102 102 102 102 102 103 103 103 103 103 103 103 103 
102 102 102 64 66 127 37 37 37 37 127 37 37 37 37 37 37 37 37 65 68 67 66 124 37 37 124 37 73 102 64 68 67 68 66 65 69 102 102 102 102 102 103 103 103 103 103 103 103 103 
102 102 102 70 37 37 127 37 37 37 37 37 37 37 37 37 37 37 37 37 37 37 37 37 124 37 124 124 65 68 66 37 110 37 139 110 73 102 102 102 102 102 102 103 103 103 103 103 103 103 
102 102 102 70 37 37 128 37 128 37 37 37 137 37 22 22 22 22 22 22 37 37 37 37 37 37 37 37 37 37 37 37 140 37 139 140 65 69 102 102 102 102 102 102 103 103 103 103 103 103 
102 102 102 70 37 127 37 37 37 37 37 137 137 137 22 37 37 37 37 22 22 37 37 37 37 37 37 37 37 37 37 37 37 37 110 37 37 65 69 102 102 102 102 102 102 103 103 103 103 103 
102 102 64 66 37 37 22 37 22 22 22 22 22 22 22 37 37 37 37 37 22 22 22 22 22 22 37 37 37 37 37 37 37 37 37 37 110 37 73 102 102 102 102 102 102 102 103 103 103 103 
102 64 66 37 37 37 22 37 133 37 137 137 37 37 37 37 37 37 37 37 37 37 37 37 37 0 22 22 22 37 37 37 37 37 37 37 37 37 65 69 102 102 102 102 102 103 103 103 103 103 
102 70 119 37 37 37 22 37 37 137 137 37 37 37 37 37 37 37 37 37 37 130 37 37 37 0 22 0 0 0 0 22 22 22 37 37 37 37 37 73 102 102 102 102 102 103 103 103 102 102 
102 70 37 37 37 37 22 37 37 37 37 37 37 37 37 37 37 37 37 37 37 107 37 107 37 0 0 0 0 0 0 37 37 22 22 22 22 37 37 73 102 102 102 102 102 103 103 103 103 103 
102 70 119 37 37 37 22 22 37 37 37 37 37 37 71 76 75 76 72 37 131 37 37 37 37 37 0 0 0 0 37 37 37 37 37 37 22 37 37 65 69 102 102 102 102 103 103 103 103 103 
102 70 37 134 37 37 37 22 37 37 37 134 134 71 77 102 103 102 74 72 37 37 130 107 37 107 0 0 0 104 37 37 37 37 37 37 22 22 37 134 73 102 102 102 102 103 103 103 103 103 
102 70 134 37 37 37 22 22 119 71 75 75 75 77 102 103 103 103 102 70 37 107 37 107 37 37 22 37 37 37 37 37 37 37 37 37 37 22 37 134 73 102 102 102 102 103 103 103 103 103 
102 70 37 37 37 22 22 37 71 77 102 102 102 103 103 103 103 103 102 70 37 37 37 37 37 37 22 22 37 37 37 37 37 37 37 37 37 22 134 37 73 102 102 102 102 103 103 103 103 103 
102 74 72 37 37 22 37 37 73 102 102 103 103 103 103 103 103 102 102 74 72 37 37 107 107 37 37 22 37 37 37 37 37 37 37 37 134 22 134 134 65 68 69 102 102 103 103 102 102 102 
102 102 70 37 37 22 37 37 65 69 102 102 103 103 103 103 103 102 102 102 70 37 37 37 37 37 37 22 37 37 37 71 75 76 72 37 37 22 37 134 37 71 77 102 102 102 103 102 102 102 
102 102 70 37 37 22 37 37 107 73 102 102 103 103 103 103 103 103 102 102 70 37 37 37 37 37 22 22 37 37 71 77 102 102 74 72 134 22 22 22 37 65 69 102 102 102 103 102 102 102 
102 102 70 37 113 22 37 37 37 73 102 102 102 103 103 103 103 103 102 102 70 37 37 37 37 37 22 37 37 37 65 69 102 103 64 66 37 37 134 22 37 37 73 102 102 102 102 102 103 103 
102 64 66 113 37 22 37 37 37 73 102 102 102 103 103 103 103 102 102 102 74 72 37 37 37 37 22 37 37 37 37 65 67 68 66 134 134 37 134 22 37 37 73 102 102 102 102 102 103 103 
102 70 37 37 37 22 22 37 37 65 69 102 102 103 103 103 103 103 103 102 102 74 72 37 37 37 22 22 37 37 37 37 37 37 37 134 37 134 37 22 37 119 73 102 102 102 102 102 103 103 
102 70 37 37 137 37 22 137 37 37 73 102 102 102 103 103 103 103 103 103 102 102 70 37 37 37 37 22 37 37 37 37 37 37 37 37 37 37 37 22 37 37 77 102 103 102 102 103 103 103 
102 70 37 37 137 137 22 137 37 37 73 102 102 102 103 103 103 103 103 103 102 102 70 37 37 37 37 22 22 37 37 37 37 37 37 37 37 37 22 22 71 77 102 103 103 102 102 103 102 103 
102 74 76 72 137 37 22 137 37 37 73 102 102 102 103 103 103 103 103 102 64 67 66 37 37 37 37 37 22 37 37 37 37 116 37 37 22 22 22 37 73 102 102 102 103 102 102 103 102 103 
102 102 102 70 37 37 22 37 137 71 77 102 102 102 103 103 103 103 103 102 70 37 37 37 37 37 37 37 22 22 22 22 22 22 22 22 22 37 37 133 73 102 102 102 102 102 102 103 102 103 
102 102 102 74 72 37 22 37 37 73 102 64 69 102 102 102 102 102 102 64 66 37 37 37 22 22 22 22 22 37 37 37 37 140 37 22 22 37 37 104 73 102 102 102 102 102 103 103 103 102 
102 102 64 67 66 37 22 37 37 65 67 66 65 67 68 67 67 67 68 66 37 37 22 22 22 37 37 37 37 37 71 75 75 75 72 22 22 71 76 76 77 102 102 102 103 103 103 103 103 102 
102 102 70 37 37 37 22 37 37 37 37 37 37 37 37 37 37 37 37 37 22 22 22 37 37 37 71 72 71 75 77 102 102 102 95 5 7 96 102 102 102 102 102 103 103 103 103 103 103 102 
102 102 70 37 37 37 22 37 37 37 37 37 22 22 22 22 37 22 22 22 22 37 37 71 76 75 77 74 77 102 102 102 102 102 99 0 0 90 91 102 102 102 103 103 103 103 103 103 103 102 
102 102 70 37 37 37 22 37 37 37 37 22 22 37 37 22 22 22 37 37 37 37 37 77 102 102 102 102 102 102 102 102 102 88 99 8 9 90 102 102 102 103 103 103 103 103 103 103 103 103 
102 102 70 37 37 37 22 37 37 22 22 22 37 37 37 37 37 37 37 37 76 76 77 102 102 102 103 103 103 103 102 102 102 102 99 8 49 90 93 102 102 103 103 103 103 103 103 102 103 103 
64 67 66 37 37 37 22 22 22 22 37 37 37 37 37 37 75 76 75 77 102 102 102 102 103 103 103 103 103 103 102 102 102 88 99 0 18 90 102 102 102 103 103 103 103 103 103 103 103 103 
70 134 37 37 37 37 37 37 37 37 37 37 71 77 75 77 102 102 102 102 102 102 102 103 103 103 103 103 103 103 102 102 102 102 89 25 27 92 102 102 102 102 103 103 103 103 102 103 103 103 
74 76 72 37 37 37 37 37 37 37 37 37 73 102 102 102 102 102 102 102 102 102 103 103 103 103 103 103 102 102 102 102 102 64 66 30 37 65 67 68 69 102 102 102 102 103 103 103 103 102 
102 102 70 37 110 37 134 134 71 75 76 76 77 102 102 102 102 103 103 103 102 103 103 102 102 102 102 102 102 102 102 102 64 66 37 50 37 37 108 37 65 69 102 102 102 102 102 102 102 102 
102 102 74 76 72 110 71 76 77 102 102 102 102 102 102 103 103 103 103 103 103 103 103 102 102 102 64 68 67 68 67 67 66 37 37 51 18 37 37 37 37 73 102 102 102 102 102 102 102 102 
102 102 102 102 74 75 77 102 102 102 102 102 102 103 103 103 103 103 102 102 102 102 102 102 64 68 66 37 37 37 37 134 37 37 37 51 51 51 51 37 37 65 69 102 102 102 102 102 102 102 
102 102 102 102 102 102 102 102 102 102 102 102 103 103 103 103 103 103 102 102 102 102 64 68 66 134 37 51 51 51 51 37 37 37 37 51 51 37 51 51 51 51 65 68 69 102 102 102 102 102 
102 102 102 102 102 102 102 102 102 102 103 103 103 103 103 103 103 102 102 102 102 64 66 37 134 37 37 30 37 37 51 51 51 51 51 51 37 37 37 37 37 51 37 71 77 102 102 102 102 102 
102 102 102 102 102 102 102 102 102 102 102 103 103 103 103 103 102 102 102 102 64 66 37 37 37 37 37 30 37 37 37 37 37 37 37 37 37 37 37 37 37 51 37 65 69 102 102 102 102 102 
102 102 102 102 102 102 102 102 102 102 102 102 102 103 103 102 102 102 102 102 70 134 37 30 30 30 30 30 37 37 37 37 37 37 37 113 37 37 134 37 37 51 37 107 73 102 102 102 102 102 
102 102 102 102 64 67 69 102 102 102 102 102 102 102 102 102 102 102 102 102 70 37 37 30 37 37 37 37 37 37 110 37 37 37 37 37 37 37 134 37 37 51 37 127 73 102 102 102 102 102 
102 102 102 64 66 37 65 67 69 102 102 102 102 102 102 102 102 102 102 102 70 134 37 30 37 37 37 37 110 110 110 37 37 37 37 37 37 37 37 37 37 51 37 37 73 102 102 102 102 102 
102 102 102 74 72 37 37 37 73 102 102 102 102 102 102 102 102 102 102 102 74 72 37 30 37 37 37 37 37 37 37 37 37 37 37 37 37 37 37 37 37 51 37 71 77 102 102 102 102 102 
102 102 102 102 74 72 37 37 73 102 102 102 102 102 102 102 102 102 102 102 102 70 134 30 30 30 30 30 37 30 30 30 30 30 30 51 51 51 51 51 51 51 127 73 102 102 102 102 102 102 
102 102 102 102 102 74 75 76 77 102 102 102 102 103 103 102 102 102 102 102 102 74 72 134 37 37 37 30 30 30 134 134 134 134 134 134 37 37 37 37 37 37 37 73 102 102 102 102 102 102 
102 102 102 102 102 102 102 102 102 102 102 102 103 103 103 102 102 102 102 102 102 102 74 72 37 37 37 37 37 37 37 37 37 37 37 37 37 37 51 51 71 75 76 77 102 102 102 102 102 103 
102 102 102 102 102 102 102 102 102 102 102 103 103 103 103 103 102 102 102 102 102 102 102 74 72 37 37 37 37 37 71 75 76 75 76 76 75 72 51 51 73 102 102 102 102 102 102 102 103 103 
102 102 102 102 102 102 102 102 102 103 103 103 103 103 103 103 103 103 103 103 103 102 102 102 74 75 76 76 76 76 77 102 102 102 102 102 102 74 75 76 77 102 102 102 102 102 102 103 103 103 
102 102 102 102 102 102 102 102 103 103 103 103 103 103 102 103 103 103 103 102 103 103 102 102 102 102 102 102 102 102 102 102 102 102 102 102 102 102 102 102 102 102 102 102 102 103 103 103 103 103 
