102 102 102 102 102 102 102 102 102 102 102 102 102 102 102 102 102 102 102 102 102 102 102 102 102 102 102 102 102 102 102 102 102 102 102 102 102 102 102 102 102 102 102 102 102 102 102 102 102 102 
102 102 102 102 102 64 67 68 67 68 67 68 69 102 102 102 102 102 102 102 102 102 102 102 102 102 102 102 102 102 102 102 102 102 102 102 102 102 102 102 102 102 102 102 102 102 102 102 102 102 
102 102 102 102 64 66 37 37 37 37 37 37 65 67 68 67 67 68 67 69 102 102 64 68 67 68 67 67 69 102 102 102 102 102 64 69 102 102 102 102 102 102 102 102 102 102 102 102 102 102 
102 102 102 64 66 37 37 37 37 37 37 37 37 37 37 37 37 37 37 65 68 67 66 37 37 37 37 37 73 102 64 68 67 68 66 65 69 102 102 102 102 102 102 102 102 102 102 102 102 102 
102 102 102 70 37 37 37 37 37 37 37 37 37 37 37 37 37 37 37 37 37 37 37 37 37 37 37 37 65 68 66 37 37 37 37 37 73 102 102 102 102 102 102 102 102 102 102 102 102 102 
102 102 102 70 37 37 37 37 37 37 37 37 37 37 37 37 37 37 37 37 37 37 37 37 37 37 37 37 37 37 37 37 37 37 37 37 65 69 102 102 102 102 102 102 102 102 102 102 102 102 
102 102 102 70 37 37 37 37 37 37 37 37 37 37 37 37 37 37 37 37 37 37 37 37 37 37 37 37 37 37 37 37 37 37 37 37 37 65 69 102 102 102 102 102 102 102 102 102 102 102 
102 102 64 66 37 37 37 37 37 37 37 37 37 37 37 37 37 37 37 37 37 37 37 37 37 37 37 37 37 37 37 37 37 37 37 37 37 37 73 102 102 102 102 102 102 102 102 102 102 102 
102 64 66 37 37 37 37 37 37 37 37 37 37 37 37 37 37 37 37 37 37 37 37 37 37 37 37 37 37 37 37 37 37 37 37 37 37 37 65 69 102 102 102 102 102 102 102 102 102 102 
102 70 37 37 37 37 37 37 37 37 37 37 37 37 37 37 37 37 37 37 37 37 37 37 37 37 37 37 37 37 37 37 37 37 37 37 37 37 37 73 102 102 102 102 102 102 102 102 102 102 
102 70 37 37 37 37 37 37 37 37 37 37 37 37 37 37 37 37 37 37 37 37 37 37 37 37 37 37 37 37 37 37 37 37 37 37 37 37 37 73 102 102 102 102 102 102 102 102 102 102 
102 70 37 37 37 37 37 37 37 37 37 37 37 37 37 37 37 37 37 37 37 37 37 37 37 37 37 37 37 37 37 37 37 37 37 37 37 37 37 65 69 102 102 102 102 102 102 102 102 102 
102 70 37 37 37 37 37 37 37 37 37 37 37 37 37 102 102 102 37 37 37 37 37 37 37 37 37 37 37 37 37 37 37 37 37 37 37 37 37 37 73 102 102 102 102 102 102 102 102 102 
102 70 37 37 37 37 37 37 37 37 37 37 37 37 102 102 102 102 102 37 37 37 37 37 37 37 37 37 37 37 37 37 37 37 37 37 37 37 37 37 73 102 102 102 102 102 102 102 102 102 
102 70 37 37 37 37 37 37 37 37 102 102 102 102 102 102 102 102 102 37 37 37 37 37 37 37 37 37 37 37 37 37 37 37 37 37 37 37 37 37 73 102 102 102 102 102 102 102 102 102 
102 74 72 37 37 37 37 37 37 102 102 102 102 102 102 102 102 102 102 102 37 37 37 37 37 37 37 37 37 37 37 37 37 37 37 37 37 37 37 37 65 68 69 102 102 102 102 102 102 102 
102 102 70 37 37 37 37 37 37 37 102 102 102 102 102 102 102 102 102 102 37 37 37 37 37 37 37 37 37 37 37 102 102 102 102 37 37 37 37 37 37 71 77 102 102 102 102 102 102 102 
102 102 70 37 37 37 37 37 37 37 102 102 102 102 102 102 102 102 102 102 37 37 37 37 37 37 37 37 37 37 37 102 102 102 102 37 37 37 37 37 37 65 69 102 102 102 102 102 102 102 
102 102 70 37 37 37 37 37 37 37 102 102 102 102 102 102 102 102 102 102 37 37 37 37 37 37 37 37 37 37 37 102 102 102 102 37 37 37 37 37 37 37 73 102 102 102 102 102 102 102 
102 64 66 37 37 37 37 37 37 37 102 102 102 102 102 102 102 102 102 102 102 37 37 37 37 37 37 37 37 37 37 102 102 102 37 37 37 37 37 37 37 37 73 102 102 102 102 102 102 102 
102 70 37 37 37 37 37 37 37 37 37 102 102 102 102 102 102 102 102 102 102 37 37 37 37 37 37 37 37 37 37 37 37 37 37 37 37 37 37 37 37 37 73 102 102 102 102 102 102 102 
102 70 37 37 37 37 37 37 37 37 37 102 102 102 102 102 102 102 102 102 102 102 37 37 37 37 37 37 37 37 37 37 37 37 37 37 37 37 37 37 37 37 77 102 102 102 102 102 102 102 
102 70 37 37 37 37 37 37 37 37 37 102 102 102 102 102 102 102 102 102 102 102 37 37 37 37 37 37 37 37 37 37 37 37 37 37 37 37 37 37 71 77 102 102 102 102 102 102 102 102 
102 74 76 72 37 37 37 37 37 37 37 102 102 102 102 102 102 102 102 102 37 37 37 37 37 37 37 37 37 37 37 37 37 37 37 37 37 37 37 37 73 102 102 102 102 102 102 102 102 102 
102 102 102 70 37 37 37 37 37 37 37 102 102 102 102 102 102 102 102 102 37 37 37 37 37 37 37 37 37 37 37 37 37 37 37 37 37 37 37 37 73 102 102 102 102 102 102 102 102 102 
102 102 102 74 72 37 37 37 37 37 102 102 37 102 102 102 102 102 102 102 37 37 37 37 37 37 37 37 37 37 37 37 37 37 37 37 37 37 37 37 73 102 102 102 102 102 102 102 102 102 
102 102 64 67 66 37 37 37 37 37 37 37 37 37 37 37 37 37 37 37 37 37 37 37 37 37 37 37 37 37 71 75 75 75 72 37 37 71 76 76 77 102 102 102 102 102 102 102 102 102 
102 102 70 37 37 37 37 37 37 37 37 37 37 37 37 37 37 37 37 37 37 37 37 37 37 37 71 72 71 75 77 102 102 102 95 5 7 96 102 102 102 102 102 102 102 102 102 102 102 102 
102 102 70 37 37 37 37 37 37 37 37 37 37 37 37 37 37 37 37 37 37 37 37 71 76 75 77 74 77 102 102 102 102 102 99 0 0 90 91 102 102 102 102 102 102 102 102 102 102 102 
102 102 70 37 37 37 37 37 37 37 37 37 37 37 37 37 37 37 37 37 37 37 37 77 102 102 102 102 102 102 102 102 102 88 99 8 9 90 102 102 102 102 102 102 102 102 102 102 102 102 
102 102 70 37 37 37 37 37 37 37 37 37 37 37 37 37 37 37 37 37 76 76 77 102 102 102 102 102 102 102 102 102 102 102 99 8 49 90 93 102 102 102 102 102 102 102 102 102 102 102 
64 67 66 37 37 37 37 37 37 37 37 37 37 37 37 37 75 76 75 77 102 102 102 102 102 102 102 102 102 102 102 102 102 88 99 0 18 90 102 102 102 102 102 102 102 102 102 102 102 102 
70 37 37 37 37 37 37 37 37 37 37 37 71 77 75 77 102 102 102 102 102 102 102 102 102 102 102 102 102 102 102 102 102 102 89 25 27 92 102 102 102 102 102 102 102 102 102 102 102 102 
74 76 72 37 37 37 37 37 37 37 37 37 73 102 102 102 102 102 102 102 102 102 102 102 102 102 102 102 102 102 102 102 102 64 66 37 37 65 37 37 37 102 102 102 102 102 102 102 102 102 
102 102 70 37 37 37 37 37 71 75 76 76 77 102 102 102 102 102 102 102 102 102 102 102 102 102 102 102 102 102 102 102 64 66 0 37 37 37 37 37 37 37 102 102 102 102 102 102 102 102 
102 102 74 76 72 37 71 76 77 102 102 102 102 102 102 102 102 102 102 102 102 102 102 102 102 102 64 68 67 68 67 68 66 37 37 37 37 37 37 37 37 37 102 102 102 102 102 102 102 102 
102 102 102 102 74 75 77 102 102 102 102 102 102 102 102 102 102 102 102 102 102 102 102 102 64 68 66 37 37 37 37 37 37 37 37 37 37 37 37 37 37 37 37 102 102 102 102 102 102 102 
102 102 102 102 102 102 102 102 102 102 102 102 102 102 102 102 102 102 102 102 102 102 64 68 66 37 37 37 37 37 37 37 37 37 37 37 37 37 37 37 37 37 37 37 37 102 102 102 102 102 
102 102 102 102 102 102 102 102 102 102 102 102 102 102 102 102 102 102 102 102 102 64 66 37 37 37 37 37 37 37 37 37 37 37 37 37 37 37 37 37 37 37 37 37 102 102 102 102 102 102 
102 102 102 102 102 102 102 102 102 102 102 102 102 102 102 102 102 102 102 102 64 66 37 37 37 37 37 37 37 37 37 37 37 37 37 37 37 37 37 37 37 37 37 37 37 102 102 102 102 102 
102 102 102 102 102 102 102 102 102 102 102 102 102 102 102 102 102 102 102 102 70 37 37 37 37 37 37 37 37 37 37 37 37 37 37 37 37 37 37 37 37 37 37 37 37 102 102 102 102 102 
102 102 102 102 37 37 37 102 102 102 102 102 102 102 102 102 102 102 102 102 70 37 37 37 37 37 37 37 37 37 37 37 37 37 37 37 37 37 37 37 37 37 37 37 37 102 102 102 102 102 
102 102 102 37 37 37 37 37 37 102 102 102 102 102 102 102 102 102 102 102 70 37 37 37 37 37 37 37 37 37 37 37 37 37 37 37 37 37 37 37 37 37 37 37 37 102 102 102 102 102 
102 102 102 37 37 37 102 102 37 102 102 102 102 102 102 102 102 102 102 102 74 72 37 37 37 37 37 37 37 37 37 37 37 37 37 37 37 37 37 37 37 37 37 37 37 102 102 102 102 102 
102 102 102 102 37 37 37 37 37 102 102 102 102 102 102 102 102 102 102 102 102 70 37 37 37 37 37 37 37 37 37 37 37 37 37 37 37 37 37 37 37 37 37 37 102 102 102 102 102 102 
102 102 102 102 102 37 37 37 37 102 102 102 102 102 102 102 102 102 102 102 102 74 37 37 37 37 37 37 37 37 37 37 37 37 37 37 37 37 37 37 37 37 37 37 102 102 102 102 102 102 
102 102 102 102 102 102 102 102 102 102 102 102 102 102 102 102 102 102 102 102 102 102 37 37 37 37 37 37 37 37 37 37 37 37 37 37 37 37 37 37 37 37 37 102 102 102 102 102 102 102 
102 102 102 102 102 102 102 102 102 102 102 102 102 102 102 102 102 102 102 102 102 102 102 37 37 37 37 37 37 37 37 37 37 37 37 37 37 37 37 37 37 102 102 102 102 102 102 102 102 102 
102 102 102 102 102 102 102 102 102 102 102 102 102 102 102 102 102 102 102 102 102 102 102 102 37 37 37 37 37 37 37 37 37 37 37 37 37 102 102 102 102 102 102 102 102 102 102 102 102 102 
102 102 102 102 102 102 102 102 102 102 102 102 102 102 102 102 102 102 102 102 102 102 102 102 102 102 102 102 102 102 102 102 102 102 102 102 102 102 102 102 102 102 102 102 102 102 102 102 102 102 
