142 143 144 145 143 144 145 143 144 145 143 144 145 143 144 145 143 144 145 143 144 145 143 144 145 143 144 145 143 144 145 143 144 145 143 144 145 143 144 145 143 144 145 143 144 145 143 177 178 147 
150 151 151 153 151 152 153 151 152 153 151 152 153 151 152 153 151 153 153 151 152 153 151 152 153 151 152 153 151 152 153 151 153 153 151 152 153 151 152 153 151 152 153 151 152 153 151 185 186 155 
158 37 37 37 37 37 37 37 37 37 37 37 37 37 37 37 37 37 37 37 37 37 37 37 37 37 37 37 37 37 37 37 37 37 37 37 37 37 37 37 37 37 37 37 37 37 37 46 25 163 
166 37 37 197 37 37 37 37 37 37 37 37 37 37 37 37 37 37 37 37 37 37 37 133 134 133 37 37 0 24 0 24 37 37 37 37 37 27 5 5 5 5 5 5 5 5 5 5 7 171 
166 37 37 37 37 37 37 37 37 37 37 37 37 37 204 37 37 37 37 37 37 133 134 134 37 37 37 0 24 37 37 37 37 37 37 37 37 37 37 37 37 37 37 37 37 37 197 5 37 163 
158 37 37 113 71 75 76 75 76 72 113 113 71 75 76 72 110 37 37 37 37 37 37 37 24 0 24 0 37 37 37 37 37 37 37 37 37 37 37 37 37 37 37 37 37 37 37 5 37 163 
166 37 37 71 77 102 103 103 102 74 75 76 77 103 102 74 72 37 37 37 37 37 133 133 134 133 133 134 133 37 37 37 37 37 37 37 37 37 204 113 37 37 37 37 37 37 37 5 37 171 
166 37 37 73 103 103 103 103 103 103 103 103 103 102 102 64 66 37 37 37 24 37 37 37 37 37 37 37 37 37 37 37 37 37 37 37 71 75 76 75 72 134 133 134 37 37 37 5 37 163 
158 37 37 65 67 69 102 102 103 103 103 103 103 102 64 66 133 37 37 37 55 31 37 37 37 37 37 37 37 71 75 76 75 76 75 76 77 102 102 102 74 75 72 134 37 37 37 5 37 163 
166 37 37 37 37 65 102 102 103 103 103 103 102 102 70 133 37 37 37 0 55 37 37 37 37 37 71 75 76 77 102 102 102 102 102 102 102 102 103 102 103 102 70 133 37 37 5 5 37 171 
166 37 37 37 37 37 69 102 103 103 103 102 102 64 66 133 37 24 55 0 37 37 37 37 37 37 73 102 102 102 102 102 102 64 67 68 67 68 69 102 103 102 70 134 37 37 5 37 37 163 
158 37 37 37 37 37 65 67 68 69 102 64 68 66 37 37 37 0 37 37 37 37 37 37 37 71 77 102 64 67 68 67 68 66 133 134 134 134 65 69 102 102 70 133 37 37 5 37 37 163 
166 37 37 37 37 205 37 37 37 65 67 66 115 37 37 24 55 0 37 37 37 37 37 37 71 77 102 64 66 37 37 37 37 37 134 133 134 134 37 73 103 103 70 134 37 37 5 37 37 171 
166 37 37 37 37 37 37 37 37 37 37 37 37 37 37 24 37 37 37 37 113 71 75 76 77 102 102 70 37 37 37 37 37 37 37 37 37 37 37 73 102 102 70 134 37 37 5 37 37 163 
158 37 37 37 37 205 37 37 37 37 37 24 55 55 0 0 37 37 71 75 76 77 102 102 102 102 102 70 37 37 37 37 37 37 37 37 37 37 37 65 69 102 70 134 37 37 5 197 37 163 
166 37 37 37 37 37 37 37 37 37 37 0 37 37 37 205 37 71 77 102 102 102 103 103 103 103 102 70 37 37 37 37 37 37 37 37 37 37 37 37 73 102 70 37 37 37 5 37 37 171 
166 37 37 37 37 37 37 37 37 37 37 55 37 37 37 37 113 65 69 102 102 103 103 103 103 102 102 70 37 37 37 37 37 37 37 37 37 37 37 37 65 67 66 37 37 37 5 37 37 163 
158 37 37 37 37 37 37 0 55 0 55 0 37 205 37 71 75 76 77 102 102 103 103 103 102 102 64 66 37 37 37 37 37 37 37 37 37 37 37 37 37 37 37 37 37 133 5 37 37 163 
166 37 37 37 37 37 37 37 37 37 37 37 37 37 71 77 102 102 102 102 102 102 102 102 102 64 66 37 37 37 37 37 37 37 37 37 37 37 37 37 37 37 205 37 37 133 5 133 37 171 
166 37 37 37 37 37 37 37 37 37 37 37 37 204 73 102 102 64 67 68 67 68 67 68 68 66 37 37 37 37 133 37 37 37 37 37 37 37 37 37 37 37 37 37 37 134 5 134 37 163 
158 37 37 37 37 37 37 139 37 37 37 37 37 116 73 102 64 66 37 37 37 37 37 37 37 37 37 37 37 131 133 37 37 37 37 37 37 37 37 37 37 37 37 37 37 133 5 133 37 163 
166 37 37 37 37 37 37 37 37 37 37 37 37 71 77 102 74 75 76 72 37 133 37 37 37 37 37 37 37 133 37 37 37 37 131 37 37 37 37 37 37 37 37 37 133 133 5 134 37 171 
166 37 37 37 133 37 37 37 37 37 37 37 37 73 102 102 103 102 102 70 37 133 37 37 37 37 37 133 116 133 37 71 75 76 75 76 72 37 37 37 37 37 37 37 133 134 5 133 134 163 
158 37 37 37 133 133 37 37 37 37 37 37 71 77 102 103 103 102 102 70 37 131 37 37 37 37 133 133 37 37 37 73 102 102 103 103 74 75 72 37 37 37 37 37 134 133 5 133 133 163 
166 37 37 37 133 133 37 37 37 37 37 37 73 102 103 103 103 102 64 66 37 133 37 37 37 37 116 37 37 37 71 77 102 103 103 103 102 102 70 37 37 37 37 37 133 133 5 133 134 171 
166 37 37 37 134 134 37 37 37 37 37 37 65 69 102 103 103 64 66 37 133 133 37 37 37 133 133 37 37 71 77 102 103 103 103 103 102 102 70 37 37 37 37 37 133 37 5 133 37 163 
158 37 37 37 133 134 133 37 37 37 37 37 37 65 69 102 103 70 37 37 37 37 37 37 37 37 37 37 71 77 102 102 103 103 103 103 102 103 70 37 112 37 37 37 133 37 5 133 37 163 
166 37 37 37 133 133 133 37 37 37 37 37 37 37 65 67 68 66 37 37 37 37 37 37 37 37 37 37 73 102 103 103 103 103 102 102 102 64 66 37 37 37 37 37 37 133 5 37 37 171 
166 37 37 37 134 133 134 133 37 37 37 37 37 37 37 37 37 37 37 37 37 37 37 37 37 37 37 37 65 69 69 102 102 64 67 68 67 66 37 112 37 37 37 37 37 133 5 37 37 163 
158 37 37 37 133 133 134 133 37 37 37 37 37 37 37 37 197 37 37 37 37 37 37 37 37 37 37 37 115 110 65 67 68 66 115 37 37 37 37 37 37 37 37 37 37 133 37 37 37 163 
166 37 37 37 37 133 133 134 133 37 37 37 205 37 37 37 37 37 37 37 37 37 37 37 37 37 37 37 133 133 37 37 37 37 37 37 37 37 37 37 37 37 37 37 37 133 37 37 110 171 
166 37 37 37 37 37 37 37 37 37 37 37 37 37 37 37 37 37 37 37 37 197 37 37 37 37 37 37 37 37 37 37 37 37 37 37 37 37 37 37 37 37 37 113 110 108 108 110 110 163 
158 37 37 37 37 37 37 37 37 37 37 37 37 37 37 37 37 37 37 37 37 37 37 37 37 37 37 37 37 37 37 37 37 37 37 37 37 37 37 71 75 76 75 76 72 108 37 37 37 163 
166 134 180 181 37 133 37 169 133 37 169 37 133 180 181 134 37 37 37 37 37 37 37 37 37 37 37 37 37 37 37 37 37 37 37 37 37 37 71 77 102 103 103 102 70 37 37 37 37 171 
166 204 188 189 204 169 201 204 201 204 201 204 201 188 189 204 37 37 37 37 37 37 37 37 37 37 37 37 37 37 37 37 37 37 37 37 37 37 73 102 103 103 103 102 70 37 5 37 37 163 
158 113 113 113 134 133 134 134 133 134 133 113 169 134 133 204 204 204 37 71 75 76 72 133 37 37 37 37 37 37 37 37 37 37 71 76 75 76 77 102 103 103 103 102 70 37 5 37 37 163 
166 113 113 37 37 37 37 37 37 37 37 37 37 37 37 37 37 71 75 77 103 103 74 75 72 71 72 37 37 37 37 37 110 71 77 102 102 102 102 103 103 103 103 64 66 37 5 37 37 171 
166 37 37 37 37 37 37 37 37 37 37 37 37 37 37 71 75 77 103 64 69 102 102 102 74 77 74 72 37 37 37 37 71 77 103 103 103 102 103 103 103 103 64 66 37 37 5 37 37 163 
158 37 37 37 37 37 37 37 37 37 37 37 37 37 37 73 102 102 102 74 77 102 103 102 103 102 64 66 37 37 37 37 65 69 102 103 103 103 103 103 103 64 66 37 37 37 38 37 37 163 
166 37 37 37 37 37 37 37 37 37 37 37 37 37 37 73 102 102 103 103 103 102 103 103 103 102 70 37 37 37 37 37 37 65 67 68 67 68 67 68 67 66 37 37 37 37 23 37 37 171 
166 37 37 37 37 37 37 37 37 37 37 37 37 37 37 73 102 64 68 67 68 69 102 103 103 102 70 37 37 37 37 37 37 37 37 37 37 37 37 37 37 37 37 204 37 37 5 37 37 163 
158 37 37 37 37 37 37 37 37 37 37 37 37 37 37 65 67 66 37 37 37 65 67 68 67 68 66 37 37 37 37 37 37 37 197 133 134 134 133 133 133 133 37 37 37 37 5 5 37 163 
166 37 37 37 140 37 37 37 37 37 37 37 37 37 37 37 37 37 37 37 37 37 37 37 37 37 37 37 37 37 37 37 37 37 133 133 133 134 134 134 134 133 37 37 37 37 37 5 37 171 
166 37 37 37 37 37 37 37 37 140 37 37 37 37 37 37 37 37 37 37 133 37 37 37 37 37 37 37 37 37 37 37 37 37 37 37 37 37 37 37 37 37 37 37 37 37 5 5 37 163 
158 37 37 139 37 37 37 37 37 37 37 37 37 37 37 37 37 37 37 37 134 113 37 37 184 37 37 37 37 37 37 37 37 37 37 37 5 5 23 23 5 5 5 23 5 5 5 37 37 163 
166 37 37 37 37 37 37 37 37 37 37 37 37 37 37 37 37 37 37 37 37 134 37 37 160 37 37 37 37 37 37 37 205 37 5 23 5 37 37 37 37 37 37 23 37 37 37 37 37 171 
166 37 37 37 37 140 37 37 37 37 37 37 37 37 37 37 37 37 37 37 37 133 134 133 168 37 37 37 37 37 37 205 37 37 37 37 37 37 37 37 37 139 37 37 37 204 37 37 37 163 
158 37 37 37 37 37 37 37 37 37 37 37 37 37 37 37 37 37 37 37 37 134 113 37 176 37 37 37 37 37 37 37 37 37 37 37 37 37 112 37 37 37 37 37 37 37 37 37 37 163 
166 37 37 37 37 37 37 37 37 37 37 37 37 37 37 37 37 37 37 37 37 37 37 37 176 37 37 37 37 37 37 37 37 37 37 37 37 37 37 37 37 37 37 37 37 37 37 37 37 171 
174 143 144 145 143 144 145 143 144 145 143 144 145 143 144 145 143 144 145 143 144 145 143 144 184 143 144 145 143 144 145 143 144 145 143 144 145 143 144 145 143 144 145 143 144 145 143 144 145 179 
