121 121 121 121 121 121 121 121 37 37 37 206 37 37 37 37 37 37 37 37 73 102 102 103 103 103 103 102 70 37 37 37 37 37 37 37 37 37 37 37 37 37 37 37 37 37 37 37 37 37 
37 37 37 37 37 37 37 37 37 37 37 239 37 205 37 37 37 37 37 37 73 102 102 103 102 103 102 102 70 37 37 37 205 37 37 206 37 37 37 37 37 37 208 37 37 37 37 37 37 37 
37 37 37 37 37 37 37 37 37 37 37 37 37 37 37 37 37 37 37 37 65 68 67 68 67 68 67 68 66 37 205 37 37 37 37 37 37 37 37 37 37 37 37 37 37 205 37 37 37 37 
121 121 121 121 121 121 121 121 37 37 205 37 37 37 37 37 37 37 37 37 37 37 37 37 37 37 37 37 37 37 205 37 37 37 37 37 37 37 37 37 37 218 37 37 37 37 37 37 37 37 
37 37 37 37 37 37 37 37 37 37 37 37 37 37 37 212 37 37 37 37 37 37 37 37 37 37 37 37 37 37 37 37 37 37 110 110 110 110 110 110 110 110 110 110 110 110 37 37 37 37 
37 37 37 37 37 37 37 37 37 37 37 37 37 37 37 37 37 37 37 37 37 37 37 37 37 37 37 37 37 37 37 37 37 37 37 37 37 224 37 37 37 37 37 37 225 37 37 37 37 37 
121 121 121 121 121 121 121 121 37 37 37 37 214 37 37 37 37 37 37 37 37 37 37 37 37 37 37 37 37 37 37 37 37 37 37 37 37 37 37 37 37 37 37 37 37 37 37 37 37 37 
37 37 37 37 37 37 37 37 37 37 37 37 37 37 37 37 37 37 37 37 71 76 75 76 75 76 76 76 72 37 37 197 37 37 110 110 110 110 110 110 110 110 110 110 110 110 37 37 37 37 
37 37 37 37 37 37 37 37 37 37 37 37 37 37 37 37 37 37 37 115 73 102 102 102 102 102 102 102 70 37 37 37 37 37 37 37 37 37 37 37 227 37 37 37 37 37 37 37 37 37 
121 121 121 121 121 121 121 121 37 37 37 37 37 37 37 37 37 37 37 37 73 102 102 102 103 103 102 102 70 37 37 37 37 37 37 37 37 37 37 37 37 37 226 37 37 37 37 37 37 37 
37 37 37 37 37 37 37 37 37 37 37 37 37 37 37 205 37 207 71 76 77 102 102 103 103 103 102 102 70 37 37 37 37 37 110 110 110 110 110 110 110 110 110 110 110 110 37 37 37 37 
37 37 37 37 37 37 37 37 37 37 37 37 37 37 37 37 71 75 77 102 102 102 103 103 103 103 102 102 74 76 75 72 37 37 37 37 37 37 37 37 37 37 37 37 37 37 37 37 37 37 
37 37 37 37 37 37 37 37 37 37 37 37 37 37 37 71 77 102 102 102 103 103 103 103 103 103 103 103 103 103 102 74 76 75 72 37 37 37 118 37 37 37 37 37 37 37 37 37 37 37 
37 37 37 37 37 37 37 37 37 37 37 37 37 37 71 77 102 102 102 103 103 103 103 103 102 102 103 103 103 103 102 102 102 102 74 72 37 37 37 37 37 37 37 37 37 118 37 37 37 37 
37 206 37 37 37 37 37 37 118 37 37 37 37 71 77 102 102 103 103 103 102 102 102 102 64 69 102 102 102 103 103 103 102 102 102 74 72 37 37 37 37 37 37 37 37 37 37 37 37 37 
37 37 37 37 37 37 37 37 37 37 37 37 71 77 102 102 102 102 102 102 102 102 102 64 66 65 67 69 102 102 102 103 103 103 102 102 74 72 37 37 208 37 37 37 37 37 37 37 37 37 
37 37 37 208 37 37 37 37 37 37 37 71 77 102 102 102 102 102 102 64 67 68 67 66 37 115 37 65 67 69 102 102 102 103 102 102 102 70 37 239 37 37 37 37 37 37 37 37 205 37 
37 37 37 37 37 37 118 37 37 107 37 65 67 68 67 68 67 68 67 66 37 37 208 113 37 37 37 37 37 73 102 102 102 102 102 102 102 70 37 37 37 37 37 37 37 229 37 37 206 37 
37 37 37 37 37 37 37 37 37 37 37 37 37 197 37 37 37 37 37 37 37 37 37 37 37 37 37 37 37 65 67 69 102 102 102 102 102 74 75 75 72 37 37 37 37 37 37 37 37 37 
37 37 37 37 37 37 37 37 37 37 37 37 197 37 37 37 37 37 37 37 206 37 37 37 37 220 37 37 235 37 37 65 69 102 102 102 102 102 102 102 70 37 37 37 37 37 37 37 37 37 
37 107 37 37 37 37 37 37 37 37 37 37 37 37 37 37 37 37 37 37 37 207 37 37 37 37 37 37 37 37 37 37 65 69 102 102 102 102 102 102 70 115 37 37 37 37 37 37 214 37 
107 37 37 37 37 37 37 37 37 37 37 37 37 37 37 37 37 37 37 37 37 37 37 37 240 37 37 222 37 37 37 37 37 73 102 102 102 103 102 102 74 72 37 37 37 37 37 37 37 37 
75 76 75 76 75 76 75 76 75 76 75 76 75 76 72 37 37 37 37 37 37 37 225 239 113 221 37 37 37 37 37 37 37 65 69 102 102 103 103 102 102 70 37 37 37 37 37 37 37 37 
103 102 102 103 102 102 102 102 102 102 102 103 103 64 66 37 37 37 37 37 37 240 133 133 240 37 37 240 231 37 235 37 37 37 65 69 102 102 103 103 103 74 75 76 72 37 37 71 75 76 
103 103 103 103 103 102 102 103 103 102 102 103 102 70 37 37 229 37 37 37 37 37 37 239 37 37 224 37 37 37 37 37 37 37 37 73 102 102 102 102 103 103 103 102 70 37 37 73 102 103 
103 103 102 102 103 103 103 103 103 103 102 103 102 74 72 37 37 37 37 37 37 37 37 229 37 240 239 37 37 37 37 37 37 37 71 77 102 102 102 102 102 103 103 102 70 37 37 73 102 103 
102 102 102 102 102 102 102 102 102 103 103 103 102 102 74 72 37 37 37 37 212 37 37 37 37 37 37 37 214 37 37 37 37 37 73 102 102 102 102 102 102 102 103 102 70 37 37 73 102 102 
102 102 102 102 102 102 102 102 102 102 103 103 103 102 102 74 72 37 37 37 37 37 37 37 37 37 37 216 217 37 37 37 113 71 77 102 102 102 102 102 102 102 102 102 70 37 37 73 102 102 
67 68 67 68 67 68 67 69 102 102 102 102 103 103 102 102 70 37 37 37 37 37 37 37 37 37 37 37 37 37 37 37 37 73 102 102 102 102 103 102 102 102 102 102 70 37 37 73 102 102 
37 37 37 37 37 37 37 65 69 102 102 102 102 103 103 103 74 72 37 37 37 37 37 237 37 37 37 37 37 133 37 113 71 77 102 102 102 103 103 102 102 64 67 68 66 37 37 65 67 68 
37 37 37 37 37 107 37 37 65 67 69 102 102 102 102 102 102 74 75 76 72 133 37 37 37 37 37 37 133 37 37 71 77 102 102 102 103 103 102 102 64 66 37 37 37 37 37 37 37 37 
37 37 37 37 207 37 37 37 37 37 65 69 102 102 102 102 102 102 102 102 74 75 76 72 133 239 37 37 115 71 76 77 102 103 103 103 103 102 102 64 66 37 37 37 37 37 37 37 37 239 
37 37 37 208 37 206 37 37 37 37 37 65 67 68 67 69 102 102 102 102 102 102 102 70 37 37 71 75 76 77 102 103 103 103 103 102 102 64 67 66 37 205 37 37 37 37 37 37 37 37 
37 37 37 37 37 37 37 37 37 37 37 37 37 37 37 65 69 102 102 102 103 103 102 74 75 76 77 102 103 103 103 103 103 103 102 64 67 66 37 37 37 37 37 37 37 37 37 37 37 37 
37 37 37 37 205 205 37 37 37 37 218 37 37 107 37 37 73 102 102 102 102 103 102 102 102 102 102 103 103 103 103 103 102 102 64 66 37 37 37 37 37 37 37 37 37 37 37 37 37 37 
37 37 37 37 37 37 37 37 37 37 212 37 37 37 37 37 73 102 102 102 102 103 103 103 103 103 103 103 103 103 103 103 64 67 66 37 239 37 37 37 37 118 37 37 37 37 37 37 37 37 
37 37 37 37 37 37 37 37 37 37 37 37 37 37 37 37 65 67 68 69 102 102 103 103 103 103 103 103 103 103 102 64 66 37 37 37 37 37 37 37 37 37 37 37 37 118 37 37 37 37 
205 37 37 37 37 37 37 37 37 37 37 37 37 37 37 37 37 37 37 65 69 102 103 103 102 64 67 68 67 68 67 66 37 37 37 37 37 37 37 37 37 37 37 37 37 37 37 37 37 37 
37 37 37 37 37 205 37 37 37 37 37 37 37 37 37 37 37 37 37 37 73 102 102 103 102 70 37 37 37 207 37 37 37 37 37 37 37 37 37 37 197 37 37 37 37 37 37 37 37 229 
37 37 37 37 37 37 37 37 37 37 37 37 37 37 37 37 37 37 37 37 73 102 103 103 102 70 37 206 37 37 37 37 37 37 37 37 37 37 37 37 37 37 118 37 37 37 37 37 37 37 
134 134 134 134 134 134 37 37 134 134 134 134 134 134 37 37 37 37 37 205 73 102 102 103 102 70 37 37 37 37 37 37 37 37 37 37 37 37 37 37 37 37 37 37 37 37 206 37 37 37 
134 134 134 133 134 134 37 37 134 134 134 133 134 133 37 37 37 37 37 37 73 102 102 102 102 70 37 37 37 37 37 37 37 37 37 37 212 37 37 37 37 37 37 37 37 37 218 207 37 37 
134 134 134 133 133 134 37 37 134 133 133 134 133 134 37 37 37 37 37 37 65 67 68 67 68 66 37 37 37 37 37 37 37 37 37 113 113 112 113 113 113 37 37 113 113 112 113 113 113 37 
134 134 133 133 134 134 37 37 133 134 134 133 134 134 37 37 37 37 37 37 37 37 37 37 37 37 37 37 37 37 37 37 37 37 37 37 37 37 37 37 37 37 37 37 37 37 37 107 37 37 
134 134 134 133 133 134 37 37 134 133 133 134 134 133 37 37 37 37 37 37 37 37 37 37 37 205 37 37 37 37 37 37 107 37 37 113 113 113 112 112 113 37 37 113 113 113 112 113 113 37 
133 133 134 133 133 134 37 37 134 134 134 133 133 134 37 37 37 37 229 37 37 37 37 37 37 37 37 37 37 37 37 37 37 37 37 37 37 37 37 37 37 37 37 37 37 37 37 37 37 37 
134 134 134 133 134 133 37 37 133 133 133 134 133 133 37 37 37 37 37 37 37 37 37 37 37 37 37 37 37 37 37 37 37 37 37 113 112 113 113 113 113 37 37 113 112 113 113 113 113 37 
133 133 133 134 133 134 37 37 133 133 134 134 133 134 37 37 37 37 239 37 71 75 76 75 76 72 115 37 37 37 37 37 37 37 37 37 37 37 37 37 37 37 37 37 37 37 37 37 37 37 
134 134 134 133 134 134 37 37 134 134 133 133 134 134 37 37 37 37 37 37 73 102 102 103 102 70 37 37 37 37 37 37 37 37 37 113 113 113 113 113 113 37 37 113 113 113 113 113 113 37 
37 37 37 37 37 37 37 37 37 37 37 37 37 37 37 37 37 37 37 37 73 102 103 102 102 70 107 37 37 37 37 37 37 37 37 37 37 37 37 37 37 37 37 37 37 37 37 37 37 37 
